NO ./interface/textures/northNO.xpm
SO ./interface/textures/northSO.xpm
WE ./interface/textures/northWE.xpm
EA ./interface/textures/northEA.xpm

F 183,183,164
C 0,119,182

1111111111111111111111111111111111111
1000000000000000000000000000000000001
1001111000001111000001111111111111001
1001111000001111000001111111111111001
1001111000001111000001111111111111001
1001111000001111000000000000001111001
1001111111111111000001111111111111001
1001111111111111000001111111111111001
1000000000001111000001111111111111001
1000000000001111000001111000000000001
1000000000001111000001111111111111001
1000000000001111000001111111111111001
100000000000000000W000000000000000001
1111111111111111111111111111111111111