NO ./interface/textures/northNO.xpm
SO ./interface/textures/northSO.xpm
WE ./interface/textures/northWE.xpm
EA ./interface/textures/northEA.xpm

F 200,200,200
C 2,100,67

1111111111111111111111111111111111111
1000000000000000001000000000000000001
1000000000000000000000000000000000001
1000000000000000000010000000000000001
1000000000000000000000000000000000001
100000000000000000N000000000000000001
1000000000000000000000000000000000001
1000000000000000000000000000000000001
1000000000000000000000000000000000001
1000000000000000000000000000000000001
1000000000000000000000000000000000001
1000000000000000000000000011111100001
1000000000000000000000000000000000001
1111111111111111111111111111111111111