NO ./interface/textures/book.xpm
SO ./interface/textures/bricks.xpm
WE ./interface/textures/cobblestone_01.xpm
EA ./interface/textures/wet_sponge.xpm

F 188,45,193
C 0,119,182

1111111111111111111111111111111111111
1000000000000000000000000000000000001
1001111000001111000001111111111111001
1001111000001111000001111111111111001
1001111000001111000001111111111111001
1001111000001111000000000000001111001
1001111111111111000001111111111111001
1001111111111111000001111111111111001
100000000000111100N001111111111111001
1000000000001111000001111000000000001
1000000000001111000001111111111111001
1000000000001111000001111111111111001
1000000000000000000000000000000000001
1111111111111111111111111111111111111